111111
1P10E1
1001C1
100001
111111