1111111111
1010P00001
1C100000C1
1000E00001
1111111111