11111111111
1P10E010001
10010100101
100000001C1
11111111111