11111111111111111111111111111111111111111111
1P0C0000000000000000000000000000000000000001
111111000000000000000000000C0000000000000001
11111110000000000000000000000000000000000001
11111110000000000000000000000000000000000011
1111111000000000000000000000000000E000000111
111000000000001111110000C0000000000000011111
111000000000001111110000C0000000000000011111
111000000000001111110000C0000000000000011111
111000000000001111110000C0000000000000011111
11111111111111111111110000000000000000001111
11000000000111111111111111100000000011111111
1000000CC00000011111110000111000000000111111
1111100CC00000000110000000011000000000001111
11100000000000000000000110000000000000000011
11111111111111111111111111111111111111111111