11111111111111111111
10000000000000000001
10000P000000000C0001
10C00000000001100011
11000000000001100001
11111111000000C00001
11110000000001110001
10000000000001110001
1000000000C000000E01
11111111111111111111
