1111111111111
1000100000001
1000000100001
1000100100001
1111111111111