11111111111111111111
100P0000000000000111
10000010000000C10001
11111111111111011011
10C00000000001101C11
11000000000001000001
11111111000000C10011
11110000000001110001
100000000000011101C1
1000000000C00000CE01
11111111111111111111
